1111111111111111111111111111111111111111111111111111111111111111111111111111111111
1000000000000000000000000000000000000000000000000077000000770000000000000000000011
1000000000000000000000000000000000000000000000000077000000770000000000000000000011
1000000000000000000000000000000000000000000000000077000000770000000000000000000011
1000000000000000000000000000000000000000000000000077000000770000000000000000000011
1000000000000000000000000000000000000000000000000077000000770000000000000000000011
1000000000000000000000000000000000000000000000000077000000770000000000000000000011
1000000000000000000000000000000000000000000000000056000000560000000000000000000011
1000000000000000000000000000000000000000300000000000000000000000000003000000000011
1000000030030000000000300000000000000003300000300000000000000000000003300000000011
1000000330030000000003300800000080000033330030330000000000000000000833300080000411
1111111111111129211111111111111111111111111111112929292929329292921111111111111111
1999999999999992999999999999999999999999999999999292929292992929299999999999999991
1999999999999999999999999999999999999999999999999999999999999999999999999999999991
1999999999999999999999999999999999999999999999999999999999999999999999999999999991
1999999999999999999999999999999999999999999999999999999999999999999999999999999991
1999999999999999999999999999999999999999999999999999999999999999999999999999999991
1999999999999999999999999999999999999999999999999999999999999999999999999999999991