1000000000000077000000000000000000000000000000000000000077000000000000000000000011
1000000000000077000000000000000000000000000000000000000077000000000000000000000011
1000000000000077000000000000000000000000000000000000000077000000000000000000000011
1000000000000077000000000000000000000000000000000000000077000000000000000000000011
1000000000000077000000000000000000000000000000000000000077000000000000000000000011
1000000000000077000000000000000000000000000000000000000077000000000000000000000011
1000000000000056000000000000000000000000000000000000000056000000000000000000000011
1000000000000000000000000000000000000000000000000000000000000000000000000000000011
1000000000000000000000000000000000000000000000000000000000000000000003000000000011
1000000030030000000000000000000000000000000000300000030000000000000003300000000011
1000000330030000000000000000000000000000300030330000330000000000000033300000000411
1111111111111122211111111111111111111111111111111111111222522221111111111111111111
2222222222222222222222222222222222222222222222222222222222222222222222222222222222
2222222222222222222222222222222222222222222222222222222222222222222222222222222222
2222222222222222222222222222222222222222222222222222222222222222222222222222222222
2222222222222222222222222222222222222222222222222222222222222222222222222222222222
2222222222222222222222222222222222222222222222222222222222222222222222222222222222
2222222222222222222222222222222222222222222222222222222222222222222222222222222222