1111111111111111111111111111111111111111111111111111111111111111111111111111111111
1000000000000000000000077000000000000000000000000000000000077000000000000000000011
1000000000000000000000077000000000000000000000000000000000077000000000000000000011
1000000000000000000000077000000000000000000000000000000000077000000000000000000011
1000000000000000000000077000000000000000000000000000000000077000000000000000000011
1000000000000000000000077000000000000000000000000000000000077000000000000000000011
1000000000000000000000056000000000000000000000000000000000056000000000000000000011
1000000000000000000000000000000000000000000000000000000000000000000000000000000011
1000000000000000000000000000000000000000000000000000000000000000000000000000000011
1000000030000000000000000000000000000000000000300000000000000000000000000300000011
1000000333300080000000000000000000000000308030330008000000000000000008003308000411
1111111111111111129292329293332929293292111111111111111292932921111111111111111111
1999999999999999992929992929999292929929999999999999999929299299999999999999999991
1999999999999999999999999999999999999999999999999999999999999999999999999999999991
1999999999999999999999999999999999999999999999999999999999999999999999999999999991
1999999999999999999999999999999999999999999999999999999999999999999999999999999991
1999999999999999999999999999999999999999999999999999999999999999999999999999999991
1999999999999999999999999999999999999999999999999999999999999999999999999999999991