1111111111111111111111111111111111111111111111111111111111111111111111111111111111
1000000000000077000000000000000000000000000000000000000077000000000000000000000011
1000000000000077000000000000000000000000000000000000000077000000000000000000000011
1000000000000077000000000000000000000000000000000000000077000000000000000000000011
1000000000000077000000000000000000000000000000000000000077000000000000000000000011
1000000000000077000000000000000000000000000000000000000077000000000000000000000011
1000000000000056000000000000000000000000000000000000000056000000000000000000000011
1000000000000000000000000000000000000000000000000000000000000000000000000000000011
1000000000000000000000000000000000000000000000000000000000000000000003000000000011
1000000030030000000000300000000000000000000000300000030000000000000003300000000011
1000000330030000000003300800000080000000300030330000330000000000000033300080000411
1111111111112929292921111111111111111111111111111111111292329291111111111111111111
1999999999999292929299999999999999999999999999999999999929292929999999999999999991
1999999999999999999999999999999999999999999999999999999999999999999999999999999991
1999999999999999999999999999999999999999999999999999999999999999999999999999999991
1999999999999999999999999999999999999999999999999999999999999999999999999999999991
1999999999999999999999999999999999999999999999999999999999999999999999999999999991
1999999999999999999999999999999999999999999999999999999999999999999999999999999991
1999999999999999999999999999999999999999999999999999999999999999999999999999999991